TabComponent : ['TabComponent is not exist in project code']
Button : ['Button is not exist in project code']
PluginMenu : ['StaticVariableInvoking(SAI): Static Variable Invoking found: createTabsMenu invokes static variable TABS_MENU,']
FSProperties : ['There are no coupling dependencies between these two entities']
TabIcon : ['TabIcon is not exist in project code']
Sidebar : ['StaticMethodInvoking(SMI): Static Method Invoking found: Sidebar.getInstance(),  Static Method Invoking found: Sidebar.getInstance(),']
MAbout : ['MAbout is not exist in project code']
Mnemonic : ['Method Member Variable Usage Variable (MMAUA): Coupling found in method updateState, at line: 603. Instance of Mnemonic is created and used directly.', 'StaticMethodInvoking(SMI): Static Method Invoking found: Mnemonic.setExcluded(i, (i instanceof DesktopTab) || (i != editor)),', 'ConstructorInvoking(CMI): Construction Method Invoking found: new Mnemonic(this),']
TabMouseListener : ['TabMouseListener is not exist in project code']
TabsMenuAction : ['TabsMenuAction is not exist in project code']
TextEditorCore : ['TextEditorCore is not exist in project code']
OpenAllInTabsAction : ['OpenAllInTabsAction is not exist in project code']
MWizard : ['MWizard is not exist in project code']
HiddenTabsUI : ['HiddenTabsUI is not exist in project code']
StatsDialog : ['StatsDialog is not exist in project code']
MTabbedPane : ['There are no coupling dependencies between these two entities']
Browser : ['Browser is not exist in project code']
MainWindow : ['There are no coupling dependencies between these two entities']
Vars : ['StaticVariableInvoking(SAI): Static Variable Invoking found: setTabInfo invokes static variable tabsSmallIcons,  Static Variable Invoking found: setTabInfo invokes static variable tabsSmallIcons,  Static Variable Invoking found: createTabInsets invokes static variable tabsSmallIcons,  Static Variable Invoking found: popupContextMenu invokes static variable treeReadOnly,  Static Variable Invoking found: popupContextMenu invokes static variable tabsSmallIcons,  Static Variable Invoking found: popupContextMenu invokes static variable tabsSmallIcons,']
NavigationUtils : ['There are no coupling dependencies between these two entities']
VersionPanel : ['There are no coupling dependencies between these two entities']
QuickSaveAction : ['QuickSaveAction is not exist in project code']
FindAction : ['FindAction is not exist in project code']
ToggleDesignerAction : ['ToggleDesignerAction is not exist in project code']
ShowHideEditorToolBarAction : ['ShowHideEditorToolBarAction is not exist in project code']
ToggleSummaryAction : ['ToggleSummaryAction is not exist in project code']
FindNextAction : ['FindNextAction is not exist in project code']
Tree : ['There are no coupling dependencies between these two entities']
EditorPassword : ['EditorPassword is not exist in project code']
TaskManager : ['TaskManager is not exist in project code']
PrintAction : ['PrintAction is not exist in project code']
ShowHidePropertiesBarAction : ['ShowHidePropertiesBarAction is not exist in project code']
FSHelper : ['StaticMethodInvoking(SMI): Static Method Invoking found: FSHelper.renameUI(UI.windowFor(this), metaInfo),']
PropertiesPanel : ['There are no coupling dependencies between these two entities']
CloseAllAction : ['CloseAllAction is not exist in project code']
CloseAction : ['CloseAction is not exist in project code']
MSettingsDialog : ['StaticMethodInvoking(SMI): Static Method Invoking found: MSettingsDialog.showRestartInfo(),']
CloseAllOthersAction : ['CloseAllOthersAction is not exist in project code']
SessionManager : ['StaticMethodInvoking(SMI): Static Method Invoking found: SessionManager.updateMenu(menu),  Static Method Invoking found: SessionManager.deletePrivateData(),']
FeedsFS : ['There are no coupling dependencies between these two entities']
SidebarTab : ['SidebarTab is not exist in project code']
