FindAction : ['FindAction is not exist in project code']
HelpAction : ['HelpAction is not exist in project code']
PropertiesAction : ['PropertiesAction is not exist in project code']
CloseAction : ['CloseAction is not exist in project code']
PrintAction : ['PrintAction is not exist in project code']
SaveAction : ['SaveAction is not exist in project code']
ConfigureAction : ['ConfigureAction is not exist in project code']
OpenAction : ['OpenAction is not exist in project code']
PluginInfo : ['There are no coupling dependencies between these two entities']
MDataAction : ['MDataAction is not exist in project code']
Base : ['Base is not exist in project code']
Weak : ['Weak is not exist in project code']
SaveAsDefaultAction : ['SaveAsDefaultAction is not exist in project code']
MSmallButton : ['There are no coupling dependencies between these two entities']
UninstallAction : ['UninstallAction is not exist in project code']
DateAction : ['DateAction is not exist in project code']
QuitAction : ['QuitAction is not exist in project code']
MAction : ['StaticMethodInvoking(SMI): Static Method Invoking found: MAction.getMenuMask(),  Static Method Invoking found: MAction.getMenuMask(),  Static Method Invoking found: MAction.getMenuMask(),  Static Method Invoking found: MAction.getMenuMask(),  Static Method Invoking found: MAction.getMenuMask(),  Static Method Invoking found: MAction.getMenuMask(),  Static Method Invoking found: MAction.getMenuMask(),  Static Method Invoking found: MAction.getMenuMask(),  Static Method Invoking found: MAction.getFindNextKeyStroke(),  Static Method Invoking found: MAction.getFindPreviousKeyStroke(),  Static Method Invoking found: MAction.getMenuMask(),  Static Method Invoking found: MAction.getMenuMask(),  Static Method Invoking found: MAction.getMenuMask(),  Static Method Invoking found: MAction.getMenuMask(),  Static Method Invoking found: MAction.getMenuMask(),  Static Method Invoking found: MAction.getMenuMask(),  Static Method Invoking found: MAction.getMenuMask(),  Static Method Invoking found: MAction.getMenuMask(),  Static Method Invoking found: MAction.getMenuMask(),  Static Method Invoking found: MAction.getMenuMask(),  Static Method Invoking found: MAction.getMenuMask(),  Static Method Invoking found: MAction.getMenuMask(),']
MButton : ['There are no coupling dependencies between these two entities']
MMenu : ['There are no coupling dependencies between these two entities']
MDialog : ['StaticMethodInvoking(SMI): Static Method Invoking found: MDialog.of(button),']
StaticAction : ['StaticAction is not exist in project code']
SelectionAction : ['SelectionAction is not exist in project code']
TaskTable : ['There are no coupling dependencies between these two entities']
PasteAction : ['PasteAction is not exist in project code']
CopyAction : ['CopyAction is not exist in project code']
CutAction : ['CutAction is not exist in project code']
PriorityAction : ['PriorityAction is not exist in project code']
NewFolderAction : ['NewFolderAction is not exist in project code']
CompleteAction : ['CompleteAction is not exist in project code']
Paste : ['Paste is not exist in project code']
Copy : ['Copy is not exist in project code']
AddTaskAction : ['AddTaskAction is not exist in project code']
MMessage : ['There are no coupling dependencies between these two entities']
Reminder : ['There are no coupling dependencies between these two entities']
ImageInfo : ['There are no coupling dependencies between these two entities']
DefaultAction : ['DefaultAction is not exist in project code']
SelectAllAction : ['SelectAllAction is not exist in project code']
UnselectAllAction : ['UnselectAllAction is not exist in project code']
Clear : ['Clear is not exist in project code']
Cut : ['Cut is not exist in project code']
