MainView : ['StaticMethodInvoking(SMI): Static Method Invoking found: MainView.bind(searchAction, toggleDesignerAction, toggleDesktopAction, toggleSummaryAction, NavigationUtils.getPreviousAction(), NavigationUtils.getNextAction(), tabs.getCloseAllAction(), tabs.getCloseAction()),']
MApplication : ['StaticVariableInvoking(SAI): Static Variable Invoking found: initMenuBar invokes static variable offline,', 'StaticMethodInvoking(SMI): Static Method Invoking found: MApplication.getAbout(),  Static Method Invoking found: MApplication.getAbout(),  Static Method Invoking found: MApplication.getAbout(),  Static Method Invoking found: MApplication.getAbout(),']
FullScreenAction : ['FullScreenAction is not exist in project code']
ToggleDesktopAction : ['ToggleDesktopAction is not exist in project code']
Action : ['Action is not exist in project code']
UI : ['StaticMethodInvoking(SMI): Static Method Invoking found: UI.isMetal(),  Static Method Invoking found: UI.isMetal(),  Static Method Invoking found: UI.localizedQuote(editor.getMetaInfo()),  Static Method Invoking found: UI.makeHTML(i18n("Exports the content of the active document.<br>For example, you can save a \"todo\" table in the HTML format.")),  Static Method Invoking found: UI.joinSteps(i18n("Context Menu"), MActionInfo.BROWSE),  Static Method Invoking found: UI.joinSteps(i18n("Context Menu"), i18n("Copy File Path")),  Static Method Invoking found: UI.isQuaqua(),  Static Method Invoking found: UI.makeHTML(i18n("Tip: You can use drag and drop to import/export files.")),  Static Method Invoking found: UI.localizedQuote(currentFolder),  Static Method Invoking found: UI.isQuaqua(),']
AboutAction : ['AboutAction is not exist in project code']
ShowHideMainToolBarAction : ['ShowHideMainToolBarAction is not exist in project code']
ShowHideSidebarAction : ['ShowHideSidebarAction is not exist in project code']
AbstractPlugin : ['AbstractPlugin is not exist in project code']
MSystemTray : ['StaticMethodInvoking(SMI): Static Method Invoking found: MSystemTray.setBackground(MApplication.getAbout().getLightBrandColor()),  Static Method Invoking found: MSystemTray.setBackground(MApplication.getAbout().getLightBrandColor()),  Static Method Invoking found: MSystemTray.setVisible(true),  Static Method Invoking found: MSystemTray.getIcon(),']
Advanced : ['Advanced is not exist in project code']
SelectWidgetAction : ['SelectWidgetAction is not exist in project code']
ToggleDesignerAction : ['ToggleDesignerAction is not exist in project code']
ToggleSummaryAction : ['ToggleSummaryAction is not exist in project code']
MURLAction : ['MURLAction is not exist in project code']
OpenLinkAction : ['OpenLinkAction is not exist in project code']
LinkButton : ['LinkButton is not exist in project code']
MouseGestures : ['There are no coupling dependencies between these two entities']
NoteWidgetPlugin : ['There are no coupling dependencies between these two entities']
Kiosk : ['StaticVariableInvoking(SAI): Static Variable Invoking found: initMenuBar invokes static variable actionExport,  Static Variable Invoking found: initMenuBar invokes static variable actionQuit,  Static Variable Invoking found: initMenuBar invokes static variable toolBarLocked,  Static Variable Invoking found: initMenuBar invokes static variable actionFullScreen,  Static Variable Invoking found: initMenuBar invokes static variable consoleEnabled,  Static Variable Invoking found: initMenuBar invokes static variable pluginManager,  Static Variable Invoking found: initMenuBar invokes static variable actionSettings,  Static Variable Invoking found: initMenuBar invokes static variable mainWindowShowMenuBar,  Static Variable Invoking found: onInitTopics invokes static variable actionSettings,  Static Variable Invoking found: updateState invokes static variable actionZoom,  Static Variable Invoking found: onInit invokes static variable consoleEnabled,']
WidgetPlugin : ['There are no coupling dependencies between these two entities']
QuickSaveAction : ['QuickSaveAction is not exist in project code']
ZoomInAction : ['ZoomInAction is not exist in project code']
MMainWindow : ['There are no coupling dependencies between these two entities']
ShowHideEditorToolBarAction : ['ShowHideEditorToolBarAction is not exist in project code']
Button : ['Button is not exist in project code']
StandaloneApplication : ['StandaloneApplication is not exist in project code']
SummaryData : ['StaticMethodInvoking(SMI): Static Method Invoking found: SummaryData.getInstance(),']
ShowHidePropertiesBarAction : ['ShowHidePropertiesBarAction is not exist in project code']
Presentation : ['Presentation is not exist in project code']
GeneralSettings : ['ConstructorInvoking(CMI): Construction Method Invoking found: new GeneralSettings(),  Construction Method Invoking found: new GeneralSettings(),']
Context : ['Context is not exist in project code']
ZoomOutAction : ['ZoomOutAction is not exist in project code']
LocationBar : ['StaticMethodInvoking(SMI): Static Method Invoking found: LocationBar.getInstance(),  Static Method Invoking found: LocationBar.getInstance(),  Static Method Invoking found: LocationBar.getInstance(),  Static Method Invoking found: LocationBar.getInstance(),']
PropertiesAction : ['PropertiesAction is not exist in project code']
MURLButton : ['MURLButton is not exist in project code']
ConfigureAction : ['ConfigureAction is not exist in project code']
Editor : ['There are no coupling dependencies between these two entities']
InternetSearchPlugin : ['There are no coupling dependencies between these two entities']
SearchBar : ['There are no coupling dependencies between these two entities']
