Help : ['Help is not exist in project code']
MPasswordPanel : ['There are no coupling dependencies between these two entities']
Noise : ['Noise is not exist in project code']
PixelUtils : ['PixelUtils is not exist in project code']
PluginMenu : ['There are no coupling dependencies between these two entities']
HelpAction : ['HelpAction is not exist in project code']
MainWindow : ['There are no coupling dependencies between these two entities']
MDialog : ['There are no coupling dependencies between these two entities']
HTMLColorChooserForm : ['HTMLColorChooserForm is not exist in project code']
ConsoleCommand : ['There are no coupling dependencies between these two entities']
Console : ['There are no coupling dependencies between these two entities']
Args : ['StaticMethodInvoking(SMI): Static Method Invoking found: Args.getAdded(),']
MAction : ['There are no coupling dependencies between these two entities']
Clear : ['Clear is not exist in project code']
PropertiesAction : ['PropertiesAction is not exist in project code']
Action : ['Action is not exist in project code']
Paste : ['Paste is not exist in project code']
FindAction : ['FindAction is not exist in project code']
Copy : ['Copy is not exist in project code']
FindNextAction : ['FindNextAction is not exist in project code']
RenameAction : ['RenameAction is not exist in project code']
CloseAction : ['CloseAction is not exist in project code']
PrintAction : ['PrintAction is not exist in project code']
AboutAction : ['AboutAction is not exist in project code']
CropAction : ['CropAction is not exist in project code']
Cut : ['Cut is not exist in project code']
PrintPreviewPanel : ['There are no coupling dependencies between these two entities']
SelectAll : ['SelectAll is not exist in project code']
CloseAllAction : ['CloseAllAction is not exist in project code']
InsertLinkAction : ['InsertLinkAction is not exist in project code']
HTMLPreviewAction : ['HTMLPreviewAction is not exist in project code']
NextAction : ['NextAction is not exist in project code']
CloseAllOthersAction : ['CloseAllOthersAction is not exist in project code']
ShowHTMLAction : ['ShowHTMLAction is not exist in project code']
DeleteAction : ['DeleteAction is not exist in project code']
PreviousAction : ['PreviousAction is not exist in project code']
DeleteCompletedAction : ['DeleteCompletedAction is not exist in project code']
InsertLineAction : ['InsertLineAction is not exist in project code']
ConfigureAction : ['ConfigureAction is not exist in project code']
UnselectAll : ['UnselectAll is not exist in project code']
UI : ['StaticVariableInvoking(SAI): Static Variable Invoking found: processMenuItem invokes static variable HTML_BEGIN,  Static Variable Invoking found: processMenuItem invokes static variable HTML_BEGIN,  Static Variable Invoking found: processMenuItem invokes static variable HTML_END,', 'StaticMethodInvoking(SMI): Static Method Invoking found: UI.toString(tabKeys[0], ALT_MASK),  Static Method Invoking found: UI.toString(tabKeys[tabKeys.length - 1], ALT_MASK),  Static Method Invoking found: UI.toString(VK_TAB, 0),  Static Method Invoking found: UI.getMonospacedFontName(),  Static Method Invoking found: UI.toString(keyStroke),  Static Method Invoking found: UI.toString(keyCode, modifiers),']
