EditActionGroup : ['EditActionGroup is not exist in project code']
TaskPanel : ['There are no coupling dependencies between these two entities']
CircleEditor : ['Method Member Variable Usage Variable (MMAUA): Coupling found in method getCellEditor, at line: 662. Instance of CircleEditor is created and used directly.', 'ConstructorInvoking(CMI): Construction Method Invoking found: new CircleEditor(),']
ShowCompletedTasksAction : ['ShowCompletedTasksAction is not exist in project code']
AddAction : ['AddAction is not exist in project code']
PasteAction : ['PasteAction is not exist in project code']
CopyAction : ['CopyAction is not exist in project code']
CutAction : ['CutAction is not exist in project code']
DeleteAction : ['DeleteAction is not exist in project code']
DeleteCompletedAction : ['DeleteCompletedAction is not exist in project code']
Tracker : ['There are no coupling dependencies between these two entities']
SelectAllAction : ['SelectAllAction is not exist in project code']
UnselectAllAction : ['UnselectAllAction is not exist in project code']
Task : ['ReturnType(RT): Return Type found: addTask returns Task,  Return Type found: getTaskAt returns Task,', 'StaticVariableInvoking(SAI): Static Variable Invoking found: createSetValueMenuItems invokes static variable DONE,  Static Variable Invoking found: createSetValueMenuItems invokes static variable DONE,  Static Variable Invoking found: onAction invokes static variable DATE_STYLE,  Static Variable Invoking found: onAction invokes static variable TIME_STYLE,', 'StaticMethodInvoking(SMI): Static Method Invoking found: Task.getCompleteValues(),  Static Method Invoking found: Task.formatComplete(value),  Static Method Invoking found: Task.formatTime(date),  Static Method Invoking found: Task.empty(),']
PluginManager : ['There are no coupling dependencies between these two entities']
ProxyPanel : ['There are no coupling dependencies between these two entities']
TaskButton : ['TaskButton is not exist in project code']
ShowTaskAction : ['ShowTaskAction is not exist in project code']
CircleRenderer : ['ConstructorInvoking(CMI): Construction Method Invoking found: new CircleRenderer(),']
TaskPropertiesPanel : ['Method Member Variable Usage Variable (MMAUA): Coupling found in method onAction, at line: 1878. Instance of TaskPropertiesPanel is created and used directly.', 'ConstructorInvoking(CMI): Construction Method Invoking found: new TaskPropertiesPanel(Task.empty()),', 'Function Parameter Invoking Method (FPIM): Coupling found in method addTask, at line: 305. Instance of TaskPropertiesPanel parameter panel is used to callTaskPropertiesPanel's method apply.  Coupling found in method addTask, at line: 306. Instance of TaskPropertiesPanel parameter panel is used to callTaskPropertiesPanel's method getTask.', 'Method Member Variable Invoking Method (MMAIM): Coupling found in method onAction, at line: 1879. Instance of TaskPropertiesPanel is used to call member method.']
SetDurationAction : ['SetDurationAction is not exist in project code']
SetRepeatRuleAction : ['SetRepeatRuleAction is not exist in project code']
SetValueAction : ['SetValueAction is not exist in project code']
SetColorAction : ['SetColorAction is not exist in project code']
SetDateTimeAction : ['SetDateTimeAction is not exist in project code']
SetCompleteAction : ['SetCompleteAction is not exist in project code']
SetNextDateAction : ['SetNextDateAction is not exist in project code']
SummaryEditor : ['Method Member Variable Usage Variable (MMAUA): Coupling found in method getCellEditor, at line: 699. Instance of SummaryEditor is created and used directly.', 'ConstructorInvoking(CMI): Construction Method Invoking found: new SummaryEditor(),']
DateTimeEditor : ['Method Member Variable Usage Variable (MMAUA): Coupling found in method getCellEditor, at line: 675. Instance of DateTimeEditor is created and used directly.', 'ConstructorInvoking(CMI): Construction Method Invoking found: new DateTimeEditor(),']
DurationEditor : ['Method Member Variable Usage Variable (MMAUA): Coupling found in method getCellEditor, at line: 687. Instance of DurationEditor is created and used directly.', 'ConstructorInvoking(CMI): Construction Method Invoking found: new DurationEditor(),']
TaskModel : ['ConstructorInvoking(CMI): Construction Method Invoking found: new TaskModel(),']
DateTimeRenderer : ['Class Member Variable Usage Variable (CMAUA): Coupling found in method dispose, at line: 612. Instance of DateTimeRenderer member variable dateTimeRenderer is used directly.  Coupling found in method clearFontCache, at line: 1076. Instance of DateTimeRenderer member variable dateTimeRenderer is used directly.', 'Class Member Variable Invoking Variable (CMAIA): Coupling found in method clearFontCache, at line: 1077. Instance of DateTimeRenderer member variable dateTimeRenderer is used to access DateTimeRenderer's member variable promptFontBuilder.', 'StaticMethodInvoking(SMI): Static Method Invoking found: DateTimeRenderer.clearCache(),', 'ConstructorInvoking(CMI): Construction Method Invoking found: new DateTimeRenderer(),']
BooleanRenderer : ['Method Member Variable Usage Variable (MMAUA): Coupling found in method getCellEditor, at line: 681. Instance of BooleanRenderer is created and used directly.', 'ConstructorInvoking(CMI): Construction Method Invoking found: new BooleanRenderer(),  Construction Method Invoking found: new BooleanRenderer(),']
SetPriorityAction : ['SetPriorityAction is not exist in project code']
PrintDialog : ['There are no coupling dependencies between these two entities']
MRenderer : ['StaticMethodInvoking(SMI): Static Method Invoking found: MRenderer.newPlainTextInstance(),']
Node : ['Node is not exist in project code']
AddTaskAction : ['AddTaskAction is not exist in project code']
MTableFilterPanel : ['There are no coupling dependencies between these two entities']
SummaryData : ['There are no coupling dependencies between these two entities']
SummaryRenderer : ['Class Member Variable Usage Variable (CMAUA): Coupling found in method dispose, at line: 614. Instance of SummaryRenderer member variable summaryRenderer is used directly.  Coupling found in method clearFontCache, at line: 1080. Instance of SummaryRenderer member variable summaryRenderer is used directly.', 'ConstructorInvoking(CMI): Construction Method Invoking found: new SummaryRenderer(),', 'ConstructorInvoking(CMAIM): Coupling found in method clearFontCache, at line: 1080. Instance of SummaryRenderer member variable summaryRenderer is used to call SummaryRenderer's method getLabel.  Coupling found in method clearFontCache, at line: 1081. Instance of SummaryRenderer member variable summaryRenderer is used to call SummaryRenderer's method getLabel.']
