TipInfo : TipInfo is not exist in project code
Item : Item is not exist in project code
Title : Title is not exist in project code
Status : 0.0
Filter : 0.0
Action : Action is not exist in project code
Type : Type is not exist in project code
Permission : Permission is not exist in project code
SourceCode : SourceCode is not exist in project code
FeedElement : FeedElement is not exist in project code
TaskState : 0.0
Word : Word is not exist in project code
ShapeItem : ShapeItem is not exist in project code
LargeText : LargeText is not exist in project code
MActionInfo : 0.0
FeedElementOperator : FeedElementOperator is not exist in project code
OPMLReader : 0.0
MList : 0.0
AutoTag : AutoTag is not exist in project code
QueryCategory : QueryCategory is not exist in project code
WebAddress : WebAddress is not exist in project code
PluginType : 0.0
SortMethod : 0.0
Serial : Serial is not exist in project code
Icon : Icon is not exist in project code
Message : Message is not exist in project code
Conversation : Conversation is not exist in project code
MSettingsPage : 0.0
Info : Info is not exist in project code
Quote : Quote is not exist in project code
Note : Note is not exist in project code
MTextField : 0.0
MTextArea : MTextArea is not exist in project code
Tips : Tips is not exist in project code
NoteWidget : 0.0
IO : IO is not exist in project code
CoolHeader : CoolHeader is not exist in project code
Console : 0.0
SummaryEditor : 0.0
ToggleButton : ToggleButton is not exist in project code
LinkAction : LinkAction is not exist in project code
